X,X,X,X,X,X,X,X,X,X,X,X,X,X,X
X,D,,,,,,,,,,,,,X
X,,,,,,,,,,,,,,X
X,,,,,,,,,,,,,,X
X,,X,X,X,X,,,,,,,,,X
X,,X,X,,X,,,,,,,,,X
X,,X,,,X,,,,,,,,,X
X,,X,X,,X,,,,,,,,,X
X,,,,,X,,,,,,,,,X
X,X,X,,,X,,,,,,,,E,X
X,,X,,,X,,,,,,,,,X
X,,,,,,,,,,,,,,X
X,,,,,,,,,,,,,,X
X,,,,,,,,,,,,,,X
X,X,X,X,X,X,X,X,X,X,X,X,X,X,X
